Novel of size 1: +word_boundary	#
Novel of size 1: -word_boundary	E,I,S,a,e,i,k,s
Novel of size 1: +back	a
Novel of size 2: -high,+tense	e
Novel of size 3: -high,-back,-tense	E
Novel of size 1: +coronal	S,s
Novel of size 2: -high,-tense	E,a
Novel of size 2: +high,+tense	i
Novel of size 2: +high,-tense	I
Novel of size 2: -high,-back	E,e
Novel of size 1: +dorsal	k
Novel of size 1: -high	E,a,e
Novel of size 1: +tense	e,i
Novel of size 2: -back,-tense	E,I
Novel of size 1: -tense	E,I,a
Novel of size 1: -syllabic	S,k,s
Novel of size 1: +high	I,i
Novel of size 1: +anterior	s
Novel of size 1: -anterior	S
Novel of size 1: -back	E,I,e,i
Novel of size 1: +syllabic	E,I,a,e,i
